11111111111111111111
1CCC0P00000000000001

11111111111111111111
11111111111111111111
